111111
1PCCC1
1ME111
111111