11111111111
100C00100M1
1001010C111
10C10100E11
1P1MC00MC11
11111111111
11111111111
11111111111
11111111111
11111111111
