11111111111111111111111111111
1P00C000000000000000000000001
1ME00000000000000000000000001
100000M00000000000C0000000001
100000M00000000000C0000000001
100000M00000000000C0000000001
100000M00000000000C0000000001
100000M00000000000C0000000001
100000M00000000000C0000000001
100000M00000000000C0000000001
100000M00000000000C0000000001
100000M00000000000C0000000001
100000M00000000000C0000000001
100000M00000000000C0000000001
100000M00000000000C0000000001
11111111111111111111111111111