1111111111
10000000M1
1E01010C11
10P1010001
1111111111