1111111111111
100C00100M111
1001010C11111
10C10100M1M11
1P1MC000C00E1
1111111111111
