1111111111111111111111111111
1E0000000000000C00000C000001
1010010100100000101001000001
1010010010101010001001011111
1P0000000C00C0000000000000001
10CC00001111111111111100000001
1000C0100000000C000000C00001
1011111111111111111111000001
1C00000000011110000000010001
1111111111111111111111111111