1111111111
1C00000001
10P0000011
10E0000001
1111111111