1111111111
10C00M0001
1E01010011
10P1010001
1111111111