1111111111
10000000C1
10P0100011
10E0100001
1111111111